1111111111111111111111111
1000000000000000111111111
1000000100000011000011111

1011100000000S00000000000
10000000000001000000000011111111111
1111111111111111111111111
