F 0,0,0
NO sources/assets/_nwall.xpm
SO sources/assets/_swall.xpm
WE sources/assets/_wwall.xpm
EA sources/assets/_ewall.xpm
C 255, 255, 255

1111111111111111110111111
1000000000110000000000001
1011000001110000000000001
1001000000000000000000001
111111111011000001110000000000001
1000000000110000011111111111111111
11110111111111011100000010001
111111111111111111101110111111
11110111111111011101010010001
11000000110101011100000010001
100000000000000011000000100001
1000000000000000110101S0010001
110000011101010111110111100111
11110111 1110101 101111010001
11111111 1111111 111111111111