NO sources/assets/_nwall.xpm
SO sources/assets/_swall.xpm
WE sources/assets/_wwall.xpm
F 255, 255, 255

EA sources/assets/_ewall.xpm
C 255, 255,255


111111111q1111111111011111
100000000011000000000001
1011000001110000000000001
1001000000000000000000001
11111111101100001110000000000001
1000000000110000011111111111111111
11110111111111011100000010001
11111111111111111111011110111111
11110111111111011101010010001
110000001101011011100000010001
100000000000000011000000100001
1000000000000S001101010010001
110000011101010111110111100111
11110111 1110101 101111010001
11111111 1111111 111111111111
