NO sources/assets/_nwall.xpm
SO sources/assets/_swall.xpm
WE sources/assets/_wwall.xpm
EA sources/assets/_ewall.xpm
F 200,100,0
C 225,30,0
111111
1001W1
101001
1100N1
111111