NO sources/assets/_nwall.xpm
SO sources/assets/_swall.xpm
WE sources/assets/_wwall.xpm
EA sources/assets/_ewall.xpm
F 200,100,0
C 201,101,q
111111
100101
101001
1100N1
111111