111111
100101
101001
110SN1
111111
