111111
100101
101001
1100S0
111111
