111111
1001q1
101001
110S01
111111
